District,State_Abbreviation,Case_Fatality_Value,Deaths_Value,Recovered_Value,Active_Cases_Value,Confirmed_Cases_Value,Infection_rate_Value,First_Dose_Value,Second_Dose_Value,Total_Dose_Value,Covaxin_Value,Covishield_Value,Sputnik_Value,Male_Doses_Value,Female_Doses_Value,Other_Doses_Value,18_to_45_Value,45_to_60_Value,60_plus_Value
Agar Malwa, MP,1.07,35,3089,139,3263,0.02,62198,9532,71730,3723,70444,0,37114,28057,12,24214,22123,18943
Alirajpur, MP,1.32,46,3434,15,3495,0,65029,10872,75901,4840,72039,0,33842,32384,9,21232,28713,16506
Anuppur, MP,0.86,79,8719,352,9150,0.04,82737,10109,92846,12407,83179,0,46850,39111,15,28099,34649,23530
Ashoknagar, MP,0.75,27,3440,151,3618,0.02,101023,16217,117240,17626,103338,0,60152,45421,18,31453,41185,33762
Balaghat, MP,0.7,63,8727,222,9012,0.01,231725,39434,271159,29753,247988,0,125046,113072,33,70872,82455,84784
Barwani, MP,1,83,8071,149,8303,0.01,100391,21212,121603,10148,114264,0,55823,47221,16,40350,36250,26438
Betul, MP,1.58,201,12082,402,12685,0.02,196085,37479,233564,25914,211820,0,109408,90603,25,52930,79491,67574
Bhind, MP,0.97,29,2904,49,2982,0,180387,27533,207920,19191,192885,0,110839,75858,54,57215,67143,63364
Bhopal, MP,0.77,934,114831,5328,121093,0.2,740268,150366,890634,123728,799151,0,440828,345755,160,392918,246745,155340
Burhanpur, MP,1.45,37,2500,15,2552,0,108206,26225,134431,33404,106117,0,59477,53862,25,32866,44688,35714
Chhatarpur, MP,1.2,91,7400,78,7569,0,190019,26772,216791,36661,186712,0,113676,83130,31,52940,73148,70785
Chhindwara, MP,1.8,120,6454,79,6653,0,225953,53877,279830,49611,239912,0,130144,105732,43,73551,92889,69717
Damoh, MP,2.02,162,7120,739,8021,0.05,120239,20346,140585,15131,129653,0,69369,55233,14,41360,43622,39641
Datia, MP,1.12,77,6709,115,6901,0.01,102592,17268,119860,22654,99811,0,58423,48067,34,31041,33972,42507
Dewas, MP,0.62,48,7507,133,7688,0.01,193435,38349,231784,28882,213291,0,118529,91865,34,79261,74577,58727
Dhar, MP,1.01,125,12002,299,12426,0.01,230827,43743,274570,29075,253141,0,131360,106808,48,93586,85350,59112
Dindori, MP,0.61,28,4521,39,4588,0.01,79750,11437,91187,6583,87013,0,40341,42451,12,21889,31003,30039
Gwalior, MP,1.11,587,51492,815,52894,0.04,451105,75842,526947,87585,452553,0,267309,200541,93,198362,159855,113916
Harda, MP,1.81,90,4798,96,4984,0.01,68028,10231,78259,7792,73490,0,40331,31471,11,25784,25709,21313
Hoshangabad, MP,0.92,97,10390,92,10579,0.01,165926,30020,195946,27202,175717,0,97169,75577,32,56273,62154,54335
Indore, MP,0.89,1349,146720,2734,150803,0.07,1135190,221070,1356260,269650,1163409,0,676374,545157,310,589877,385301,250173
Jabalpur, MP,1.23,617,48425,983,50025,0.03,569773,112578,682351,175832,526290,0,321352,271325,134,227934,223215,144470
Jhabua, MP,0.69,53,7557,56,7666,0,77441,17827,95268,9612,88067,0,40611,39488,11,33206,24995,22126
Katni, MP,1.17,109,9205,35,9349,0,156966,21295,178261,14927,167998,0,90447,71584,20,46520,66216,49906
Khandwa, MP,2.33,94,3908,25,4027,0,154389,33906,188295,32672,157309,0,84115,72460,28,53030,54346,49571
Khargone, MP,1.61,222,13443,156,13821,0.01,187559,32968,220527,22818,209740,0,113027,86381,39,76263,71405,51706
Mandla, MP,0.33,17,5120,37,5174,0,110947,18359,129306,13371,115935,0,56889,54415,13,31583,41708,38161
Mandsaur, MP,0.98,84,8240,256,8580,0.02,149290,26171,175461,16285,159176,0,82659,66662,28,44464,59134,45733
Narsinghapur, MP,0.72,80,11003,72,11155,0.01,139720,27490,167210,14066,153144,0,79567,60509,19,41361,51655,47253
Neemuch, MP,1.07,84,7586,198,7868,0.02,118866,21806,140672,12553,128119,0,67573,52742,24,40018,46172,34515
Panna, MP,0.79,57,7152,40,7249,0,75129,12266,87395,7409,79986,0,43336,32395,8,23826,28186,23873
Raisen, MP,2.05,187,8778,172,9137,0.01,151145,21044,172189,24446,147743,0,87810,63619,30,52424,57087,41949
Rajgarh, MP,1.38,118,8138,288,8544,0.02,187073,28000,215073,16403,198670,0,110643,86063,30,78059,58818,61047
Ratlam, MP,1.74,308,16814,568,17690,0.03,178887,34714,213601,27277,186324,0,100163,80395,22,56304,74111,50137
Rewa, MP,0.74,121,16026,192,16339,0.01,366558,54901,421459,29445,392014,0,207823,159808,58,100778,132578,134345
Sagar, MP,1.76,289,15655,491,16435,0.02,447414,59507,506921,89849,417072,0,256941,201701,67,138744,179333,142166
Satna, MP,0.97,115,11703,98,11916,0,257319,41687,299006,23517,275489,0,146603,112184,34,73837,104314,80699
Sehore, MP,0.5,50,9836,206,10092,0.01,225737,36621,262358,23323,239035,0,124868,100837,33,65158,80960,79587
Seoni, MP,0.42,28,6524,165,6717,0.01,163432,30138,193570,22251,171319,0,86075,78061,29,46313,59046,58922
Shahdol, MP,1.16,117,9832,104,10053,0.01,196192,17800,213992,11207,202785,0,111437,87449,16,69165,79364,51044
Shajapur, MP,0.84,53,5934,298,6285,0.03,123125,20560,143685,15630,128055,0,70422,52851,24,38945,44546,39787
Sheopur, MP,1.54,61,3723,187,3971,0.02,69473,11038,80511,11724,68787,0,40222,31621,8,26623,27481,18175
Shivpuri, MP,0.93,115,12092,150,12357,0.01,198161,28034,226195,23650,202545,0,115563,83725,33,79779,66623,53345
Singrauli, MP,0.87,76,8597,96,8769,0.01,121801,14941,136742,8304,128438,0,74810,46991,23,40085,40219,41503
Tikamgarh, MP,1.55,106,6669,65,6840,0.01,146608,19243,165851,39447,126404,0,83677,63367,25,38616,52546,55900
Ujjain, MP,0.91,171,18361,229,18761,0.01,439308,72527,511835,88112,423723,0,238434,200876,78,157218,164178,117874
Umaria, MP,0.91,57,6036,160,6253,0.02,67620,8169,75789,5269,70520,0,38998,29613,20,19951,28184,20769
Vidisha, MP,1.82,215,11522,102,11839,0.01,174385,30953,205338,15302,190036,0,97052,78711,17,44410,57521,74298
Guna, MP.,0.86,44,4881,173,5098,0.01,145728,26694,172422,17083,160827,0,85548,65482,16,40734,56462,53758
Morena, MP.,0.99,81,7906,214,8201,0.01,205528,30283,235811,34361,201450,0,119595,86566,47,69093,69860,67440
Sidhi, MP.,0.95,87,8927,176,9190,0.02,108974,13900,122874,11758,111116,0,62117,47438,9,31708,37603,40341
